//MAP CONVERTED BY dmm2tgm.py THIS HEADER COMMENT PREVENTS RECONVERSION, DO NOT REMOVE
"a" = (
/turf/open/misc/asteroid/snow/icemoon,
/area/icemoon/surface/outdoors/nospawn)
"c" = (
/obj/structure/flora/tree/pine/style_random,
/turf/open/misc/asteroid/snow/icemoon,
/area/icemoon/surface/outdoors/nospawn)
"d" = (
/obj/effect/turf_decal/stripes/line{
	dir = 4
	},
/obj/effect/turf_decal/stripes/line{
	dir = 8
	},
/obj/machinery/door/airlock/highsecurity{
	name = "Control Room"
	},
/obj/effect/mapping_helpers/airlock/access/all/science/rd,
/obj/structure/cable,
/obj/machinery/atmospherics/pipe/smart/manifold4w/scrubbers/hidden/layer2,
/obj/machinery/atmospherics/pipe/smart/manifold4w/supply/hidden/layer4,
/obj/effect/decal/cleanable/dirt/dust,
/turf/open/floor/iron/dark,
/area/ruin/icemoon_comms_station)
"e" = (
/obj/machinery/atmospherics/components/trinary/filter/layer2{
	dir = 8
	},
/obj/structure/closet/emcloset/wall/directional/south,
/obj/effect/decal/cleanable/dirt/dust,
/turf/open/floor/plating,
/area/ruin/icemoon_comms_station)
"f" = (
/obj/structure/window/reinforced/fulltile/ice,
/obj/structure/grille,
/obj/structure/cable,
/turf/open/floor/plating,
/area/ruin/icemoon_comms_station)
"g" = (
/obj/effect/turf_decal/stripes/line{
	dir = 1
	},
/obj/structure/cable,
/obj/machinery/atmospherics/pipe/smart/manifold4w/supply/hidden/layer4,
/obj/machinery/atmospherics/components/unary/vent_scrubber/on/layer2{
	dir = 1
	},
/obj/effect/decal/cleanable/dirt/dust,
/turf/open/floor/plating,
/area/ruin/icemoon_comms_station)
"h" = (
/obj/machinery/power/apc/auto_name/directional/east,
/obj/effect/mapping_helpers/apc/full_charge,
/obj/effect/mapping_helpers/apc/unlocked,
/obj/effect/mapping_helpers/apc/cell_5k,
/obj/structure/cable,
/obj/machinery/atmospherics/pipe/smart/manifold4w/supply/hidden,
/obj/effect/decal/cleanable/dirt/dust,
/turf/open/floor/plating,
/area/ruin/icemoon_comms_station)
"i" = (
/obj/machinery/atmospherics/components/unary/vent_pump/on/layer4{
	dir = 8
	},
/obj/structure/closet/secure_closet/freezer/fridge/all_access,
/obj/effect/spawner/random/food_or_drink/donkpockets,
/obj/effect/decal/cleanable/dirt/dust,
/turf/open/floor/iron/dark,
/area/ruin/icemoon_comms_station)
"j" = (
/turf/template_noop,
/area/template_noop)
"k" = (
/obj/machinery/atmospherics/pipe/smart/manifold4w/supply/hidden,
/obj/machinery/atmospherics/pipe/smart/manifold4w/supply/hidden/layer4,
/obj/effect/decal/cleanable/dirt/dust,
/turf/open/floor/plating,
/area/ruin/icemoon_comms_station)
"l" = (
/obj/effect/turf_decal/stripes/line,
/obj/structure/cable,
/obj/machinery/atmospherics/pipe/smart/manifold4w/supply/hidden/layer4,
/obj/machinery/atmospherics/pipe/smart/manifold4w/scrubbers/hidden/layer2,
/obj/machinery/space_heater/wall_mounted/directional/east,
/obj/effect/decal/cleanable/dirt/dust,
/turf/open/floor/plating,
/area/ruin/icemoon_comms_station)
"m" = (
/obj/effect/turf_decal/stripes/corner{
	dir = 4
	},
/obj/structure/cable,
/obj/machinery/power/terminal,
/obj/machinery/atmospherics/components/unary/vent_pump/on/layer4{
	dir = 4
	},
/obj/machinery/space_heater/wall_mounted/directional/west,
/obj/machinery/power/port_gen/pacman/pre_loaded,
/obj/effect/decal/cleanable/dirt/dust,
/turf/open/floor/plating,
/area/ruin/icemoon_comms_station)
"n" = (
/turf/closed/wall/r_wall,
/area/ruin/icemoon_comms_station)
"p" = (
/obj/structure/table,
/obj/structure/cable,
/obj/effect/decal/cleanable/dirt/dust,
/turf/open/floor/iron/dark,
/area/ruin/icemoon_comms_station)
"q" = (
/obj/structure/cable,
/obj/machinery/power/colony_wind_turbine,
/turf/open/floor/plating/snowed/smoothed/icemoon,
/area/icemoon/surface/outdoors/nospawn)
"r" = (
/turf/closed/wall/r_wall/rust,
/area/ruin/icemoon_comms_station)
"s" = (
/obj/structure/cable,
/obj/machinery/atmospherics/pipe/layer_manifold/supply/hidden{
	dir = 4
	},
/obj/effect/decal/cleanable/dirt/dust,
/turf/open/floor/plating,
/area/ruin/icemoon_comms_station)
"t" = (
/obj/effect/turf_decal/stripes/line,
/obj/effect/turf_decal/stripes/line{
	dir = 1
	},
/obj/machinery/door/airlock/external/ruin,
/obj/effect/mapping_helpers/airlock/access/all/science/general,
/obj/effect/mapping_helpers/airlock/cyclelink_helper,
/obj/structure/cable,
/obj/effect/decal/cleanable/dirt/dust,
/turf/open/floor/plating,
/area/ruin/icemoon_comms_station)
"u" = (
/obj/structure/flora/grass/brown/style_random,
/turf/open/misc/asteroid/snow/icemoon,
/area/icemoon/surface/outdoors/nospawn)
"v" = (
/obj/machinery/atmospherics/pipe/smart/manifold4w/scrubbers/hidden/layer2,
/turf/closed/wall/r_wall/rust,
/area/ruin/icemoon_comms_station)
"w" = (
/obj/structure/cable,
/obj/machinery/atmospherics/components/trinary/filter/layer2{
	dir = 1
	},
/obj/machinery/airalarm/directional/west,
/obj/effect/mapping_helpers/airalarm/unlocked,
/obj/effect/decal/cleanable/dirt/dust,
/turf/open/floor/plating,
/area/ruin/icemoon_comms_station)
"y" = (
/obj/structure/cable,
/obj/machinery/atmospherics/pipe/smart/manifold4w/scrubbers/hidden/layer2,
/obj/machinery/atmospherics/pipe/smart/manifold4w/supply/hidden/layer4,
/obj/effect/decal/cleanable/dirt/dust,
/turf/open/floor/carpet/grimey,
/area/ruin/icemoon_comms_station)
"z" = (
/obj/effect/turf_decal/stripes/corner{
	dir = 1
	},
/obj/machinery/atmospherics/components/tank/air,
/obj/machinery/light/small/directional/north,
/obj/effect/decal/cleanable/dirt/dust,
/turf/open/floor/plating,
/area/ruin/icemoon_comms_station)
"A" = (
/obj/effect/turf_decal/stripes/line{
	dir = 1
	},
/obj/structure/cable,
/obj/machinery/atmospherics/pipe/smart/manifold4w/supply/hidden/layer4,
/obj/machinery/airalarm/directional/east,
/obj/effect/mapping_helpers/airalarm/unlocked,
/obj/effect/decal/cleanable/dirt/dust,
/turf/open/floor/plating,
/area/ruin/icemoon_comms_station)
"B" = (
/obj/machinery/light/small/directional/north,
/obj/structure/table,
/obj/structure/cable,
/obj/effect/decal/cleanable/dirt/dust,
/turf/open/floor/iron/dark,
/area/ruin/icemoon_comms_station)
"C" = (
/obj/machinery/atmospherics/pipe/smart/manifold4w/scrubbers/hidden/layer2,
/turf/closed/wall/r_wall,
/area/ruin/icemoon_comms_station)
"D" = (
/obj/structure/sign/flag/nanotrasen/directional/south,
/turf/open/misc/asteroid/snow/icemoon,
/area/icemoon/surface/outdoors/nospawn)
"E" = (
/obj/structure/table/wood,
/obj/effect/decal/cleanable/dirt/dust,
/obj/item/paper_bin{
	pixel_x = 2;
	pixel_y = 4
	},
/obj/item/pen{
	pixel_x = 2;
	pixel_y = 5
	},
/obj/item/stamp/denied{
	pixel_x = -9;
	pixel_y = 12
	},
/obj/item/stamp/granted{
	pixel_x = -11;
	pixel_y = 1
	},
/turf/open/floor/carpet/grimey,
/area/ruin/icemoon_comms_station)
"F" = (
/obj/structure/table,
/obj/structure/cable,
/obj/machinery/microwave,
/obj/effect/decal/cleanable/dirt/dust,
/turf/open/floor/iron/dark,
/area/ruin/icemoon_comms_station)
"G" = (
/obj/structure/table/wood,
/obj/machinery/airalarm/directional/east,
/obj/effect/mapping_helpers/airalarm/unlocked,
/obj/effect/decal/cleanable/dirt/dust,
/obj/machinery/fax{
	visible_to_network = 0;
	name = "Communications Outpost Fax Machine";
	fax_name = "Communications Relay Post Delta-2"
	},
/turf/open/floor/carpet/grimey,
/area/ruin/icemoon_comms_station)
"H" = (
/obj/structure/cable,
/obj/machinery/power/smes/super/full,
/obj/effect/decal/cleanable/dirt/dust,
/turf/open/floor/plating,
/area/ruin/icemoon_comms_station)
"I" = (
/obj/effect/turf_decal/stripes/corner,
/obj/structure/rack,
/obj/machinery/atmospherics/components/unary/vent_scrubber/on/layer2{
	dir = 4
	},
/obj/item/clothing/mask/gas/explorer{
	pixel_x = -4;
	pixel_y = 5
	},
/obj/item/tank/internals/emergency_oxygen/double{
	pixel_x = 6;
	pixel_y = -1
	},
/obj/effect/decal/cleanable/dirt/dust,
/turf/open/floor/plating,
/area/ruin/icemoon_comms_station)
"K" = (
/obj/structure/cable,
/turf/open/floor/plating/snowed/smoothed/icemoon,
/area/icemoon/surface/outdoors/nospawn)
"M" = (
/obj/structure/filingcabinet,
/obj/effect/decal/cleanable/dirt/dust,
/turf/open/floor/carpet/grimey,
/area/ruin/icemoon_comms_station)
"N" = (
/obj/structure/cable,
/turf/open/misc/asteroid/snow/icemoon,
/area/icemoon/surface/outdoors/nospawn)
"O" = (
/obj/machinery/atmospherics/pipe/smart/manifold4w/scrubbers/hidden/layer2,
/obj/machinery/portable_atmospherics/canister/oxygen,
/obj/effect/turf_decal/delivery,
/obj/machinery/light/small/directional/south,
/obj/effect/decal/cleanable/dirt/dust,
/turf/open/floor/plating,
/area/ruin/icemoon_comms_station)
"P" = (
/obj/effect/turf_decal/stripes/corner{
	dir = 4
	},
/obj/structure/rack,
/obj/machinery/atmospherics/components/unary/vent_pump/on/layer4{
	dir = 4
	},
/obj/item/clothing/suit/hooded/wintercoat/science{
	pixel_x = 2;
	pixel_y = 6
	},
/obj/item/flashlight/lantern/rayne{
	pixel_x = -9;
	pixel_y = 5
	},
/obj/machinery/light/small/directional/west,
/obj/effect/decal/cleanable/dirt/dust,
/turf/open/floor/plating,
/area/ruin/icemoon_comms_station)
"Q" = (
/obj/machinery/atmospherics/pipe/smart/manifold4w/scrubbers/hidden/layer2,
/obj/machinery/atmospherics/pipe/smart/manifold4w/supply/hidden/layer4,
/obj/structure/cable,
/obj/effect/decal/cleanable/dirt/dust,
/turf/open/floor/iron/dark,
/area/ruin/icemoon_comms_station)
"R" = (
/obj/machinery/atmospherics/components/unary/vent_scrubber/on/layer2{
	dir = 4
	},
/obj/machinery/space_heater/wall_mounted/directional/west,
/obj/effect/decal/cleanable/dirt/dust,
/turf/open/floor/iron/dark,
/area/ruin/icemoon_comms_station)
"S" = (
/obj/effect/turf_decal/stripes/line,
/obj/effect/turf_decal/stripes/line{
	dir = 1
	},
/obj/machinery/door/airlock/external/ruin,
/obj/effect/mapping_helpers/airlock/access/all/science/general,
/obj/effect/mapping_helpers/airlock/cyclelink_helper{
	dir = 1
	},
/obj/structure/cable,
/obj/machinery/atmospherics/pipe/smart/manifold4w/supply/hidden/layer4,
/obj/machinery/atmospherics/pipe/smart/manifold4w/scrubbers/hidden/layer2,
/obj/effect/decal/cleanable/dirt/dust,
/turf/open/floor/plating,
/area/ruin/icemoon_comms_station)
"T" = (
/obj/machinery/atmospherics/pipe/smart/manifold4w/scrubbers/hidden/layer2,
/obj/structure/closet/crate,
/obj/item/storage/toolbox/mechanical,
/obj/item/stack/sheet/iron/fifty,
/obj/item/stack/sheet/mineral/plasma/twenty,
/obj/effect/decal/cleanable/dirt/dust,
/obj/item/storage/box/lights/bulbs,
/obj/item/storage/toolbox/electrical,
/turf/open/floor/plating,
/area/ruin/icemoon_comms_station)
"U" = (
/turf/closed/wall/rust,
/area/ruin/icemoon_comms_station)
"W" = (
/obj/structure/cable,
/obj/machinery/computer/terminal/craterstation/comms_station{
	dir = 1
	},
/obj/effect/decal/cleanable/dirt/dust,
/turf/open/floor/carpet/grimey,
/area/ruin/icemoon_comms_station)
"Y" = (
/obj/structure/cable,
/obj/machinery/atmospherics/components/trinary/mixer/layer2{
	dir = 4
	},
/obj/machinery/atmospherics/pipe/smart/manifold4w/supply/hidden,
/obj/machinery/atmospherics/pipe/smart/manifold4w/supply/hidden/layer4,
/obj/effect/decal/cleanable/dirt/dust,
/turf/open/floor/plating,
/area/ruin/icemoon_comms_station)
"Z" = (
/turf/closed/wall,
/area/ruin/icemoon_comms_station)

(1,1,1) = {"
j
j
j
j
j
a
c
a
j
j
j
a
a
a
j
"}
(2,1,1) = {"
j
j
j
a
a
a
a
a
a
a
a
a
a
c
a
"}
(3,1,1) = {"
j
j
j
a
a
a
a
a
a
a
a
a
a
a
a
"}
(4,1,1) = {"
j
j
c
a
U
Z
Z
n
n
r
r
n
n
a
a
"}
(5,1,1) = {"
j
a
a
a
U
P
I
n
m
H
w
O
n
a
c
"}
(6,1,1) = {"
c
a
K
K
t
A
l
S
g
k
Y
e
n
a
a
"}
(7,1,1) = {"
a
a
K
D
Z
Z
U
v
z
h
s
T
n
u
a
"}
(8,1,1) = {"
a
a
N
a
q
K
q
v
v
v
d
C
n
a
a
"}
(9,1,1) = {"
c
a
K
a
a
K
a
f
p
R
y
E
n
a
u
"}
(10,1,1) = {"
a
a
K
K
K
K
q
n
B
Q
y
W
f
a
a
"}
(11,1,1) = {"
u
a
a
a
a
K
a
f
F
i
G
M
r
a
c
"}
(12,1,1) = {"
j
a
a
a
q
K
q
n
n
n
r
r
r
a
a
"}
(13,1,1) = {"
j
j
c
u
a
a
a
a
a
u
a
a
a
a
j
"}
(14,1,1) = {"
j
j
a
a
a
u
a
a
a
a
a
a
a
c
j
"}
(15,1,1) = {"
j
j
j
j
a
a
j
j
a
c
u
j
j
j
j
"}
