//MAP CONVERTED BY dmm2tgm.py THIS HEADER COMMENT PREVENTS RECONVERSION, DO NOT REMOVE
"a" = (
/turf/open/misc/asteroid/snow/icemoon,
/area/icemoon/surface/outdoors/nospawn)
"b" = (
/obj/machinery/atmospherics/components/trinary/filter/layer2{
	dir = 8
	},
/turf/open/floor/plating,
/area/ruin/icemoon_comms_station)
"c" = (
/obj/machinery/power/apc/auto_name/directional/east,
/obj/effect/mapping_helpers/apc/full_charge,
/obj/effect/mapping_helpers/apc/unlocked,
/obj/effect/mapping_helpers/apc/cell_5k,
/obj/structure/cable,
/obj/machinery/atmospherics/pipe/smart/manifold4w/supply/hidden,
/turf/open/floor/plating,
/area/ruin/icemoon_comms_station)
"d" = (
/obj/structure/cable,
/turf/open/floor/plating/snowed/smoothed/icemoon,
/area/icemoon/surface/outdoors/nospawn)
"e" = (
/obj/machinery/atmospherics/pipe/smart/manifold4w/supply/hidden,
/obj/machinery/atmospherics/pipe/smart/manifold4w/supply/hidden/layer4,
/turf/open/floor/plating,
/area/ruin/icemoon_comms_station)
"g" = (
/obj/effect/turf_decal/stripes/corner{
	dir = 4
	},
/obj/structure/cable,
/obj/machinery/power/terminal,
/obj/machinery/atmospherics/components/unary/vent_pump/on/layer4{
	dir = 4
	},
/obj/machinery/space_heater/wall_mounted/directional/west,
/turf/open/floor/plating,
/area/ruin/icemoon_comms_station)
"i" = (
/obj/machinery/light/small/directional/north,
/obj/structure/table,
/obj/structure/cable,
/turf/open/floor/iron/dark,
/area/ruin/icemoon_comms_station)
"j" = (
/turf/template_noop,
/area/template_noop)
"k" = (
/obj/machinery/atmospherics/pipe/smart/manifold4w/scrubbers/hidden/layer2,
/obj/machinery/atmospherics/pipe/smart/manifold4w/supply/hidden/layer4,
/obj/structure/cable,
/turf/open/floor/iron/dark,
/area/ruin/icemoon_comms_station)
"l" = (
/obj/effect/turf_decal/stripes/line{
	dir = 4
	},
/obj/effect/turf_decal/stripes/line{
	dir = 8
	},
/obj/machinery/door/airlock/highsecurity{
	name = "Control Room"
	},
/obj/effect/mapping_helpers/airlock/access/all/science/rd,
/obj/structure/cable,
/obj/machinery/atmospherics/pipe/smart/manifold4w/scrubbers/hidden/layer2,
/obj/machinery/atmospherics/pipe/smart/manifold4w/supply/hidden/layer4,
/turf/open/floor/iron/dark,
/area/ruin/icemoon_comms_station)
"m" = (
/obj/effect/turf_decal/stripes/line{
	dir = 1
	},
/obj/structure/cable,
/obj/machinery/atmospherics/pipe/smart/manifold4w/supply/hidden/layer4,
/obj/machinery/atmospherics/components/unary/vent_scrubber/on/layer2{
	dir = 1
	},
/turf/open/floor/plating,
/area/ruin/icemoon_comms_station)
"p" = (
/obj/structure/table,
/obj/structure/cable,
/obj/machinery/microwave,
/turf/open/floor/iron/dark,
/area/ruin/icemoon_comms_station)
"q" = (
/obj/structure/table/wood,
/turf/open/floor/carpet/grimey,
/area/ruin/icemoon_comms_station)
"r" = (
/obj/structure/cable,
/turf/open/misc/asteroid/snow/icemoon,
/area/icemoon/surface/outdoors/nospawn)
"s" = (
/obj/structure/cable,
/obj/machinery/computer/terminal/craterstation/comms_station{
	dir = 1
	},
/turf/open/floor/carpet/grimey,
/area/ruin/icemoon_comms_station)
"u" = (
/obj/structure/table/wood,
/obj/machinery/airalarm/directional/east,
/obj/effect/mapping_helpers/airalarm/unlocked,
/turf/open/floor/carpet/grimey,
/area/ruin/icemoon_comms_station)
"v" = (
/obj/structure/table,
/obj/structure/cable,
/turf/open/floor/iron/dark,
/area/ruin/icemoon_comms_station)
"w" = (
/obj/machinery/atmospherics/components/unary/vent_scrubber/on/layer2{
	dir = 4
	},
/obj/machinery/space_heater/wall_mounted/directional/west,
/turf/open/floor/iron/dark,
/area/ruin/icemoon_comms_station)
"x" = (
/obj/effect/turf_decal/stripes/line,
/obj/effect/turf_decal/stripes/line{
	dir = 1
	},
/obj/machinery/door/airlock/external/ruin,
/obj/effect/mapping_helpers/airlock/access/all/science/general,
/obj/effect/mapping_helpers/airlock/cyclelink_helper{
	dir = 1
	},
/obj/structure/cable,
/obj/machinery/atmospherics/pipe/smart/manifold4w/supply/hidden/layer4,
/obj/machinery/atmospherics/pipe/smart/manifold4w/scrubbers/hidden/layer2,
/turf/open/floor/plating,
/area/ruin/icemoon_comms_station)
"y" = (
/obj/structure/sign/flag/nanotrasen/directional/south,
/turf/open/misc/asteroid/snow/icemoon,
/area/icemoon/surface/outdoors/nospawn)
"A" = (
/obj/effect/turf_decal/stripes/corner{
	dir = 4
	},
/obj/structure/rack,
/obj/machinery/atmospherics/components/unary/vent_pump/on/layer4{
	dir = 4
	},
/obj/item/clothing/suit/hooded/wintercoat/science{
	pixel_x = 2;
	pixel_y = 6
	},
/obj/item/flashlight/lantern/rayne{
	pixel_x = -9;
	pixel_y = 5
	},
/obj/machinery/light/small/directional/west,
/turf/open/floor/plating,
/area/ruin/icemoon_comms_station)
"B" = (
/turf/closed/wall/rust,
/area/ruin/icemoon_comms_station)
"C" = (
/obj/structure/cable,
/obj/machinery/atmospherics/components/trinary/filter/layer2{
	dir = 1
	},
/obj/machinery/airalarm/directional/west,
/obj/effect/mapping_helpers/airalarm/unlocked,
/turf/open/floor/plating,
/area/ruin/icemoon_comms_station)
"D" = (
/obj/structure/cable,
/obj/machinery/power/smes/super/full,
/turf/open/floor/plating,
/area/ruin/icemoon_comms_station)
"E" = (
/obj/effect/turf_decal/stripes/line,
/obj/effect/turf_decal/stripes/line{
	dir = 1
	},
/obj/machinery/door/airlock/external/ruin,
/obj/effect/mapping_helpers/airlock/access/all/science/general,
/obj/effect/mapping_helpers/airlock/cyclelink_helper,
/obj/structure/cable,
/turf/open/floor/plating,
/area/ruin/icemoon_comms_station)
"F" = (
/obj/machinery/atmospherics/pipe/smart/manifold4w/scrubbers/hidden/layer2,
/turf/closed/wall/r_wall,
/area/ruin/icemoon_comms_station)
"G" = (
/obj/structure/cable,
/obj/machinery/atmospherics/components/trinary/mixer/layer2{
	dir = 4
	},
/obj/machinery/atmospherics/pipe/smart/manifold4w/supply/hidden,
/obj/machinery/atmospherics/pipe/smart/manifold4w/supply/hidden/layer4,
/turf/open/floor/plating,
/area/ruin/icemoon_comms_station)
"H" = (
/obj/machinery/atmospherics/pipe/smart/manifold4w/scrubbers/hidden/layer2,
/turf/closed/wall/r_wall/rust,
/area/ruin/icemoon_comms_station)
"I" = (
/obj/effect/turf_decal/stripes/line,
/obj/structure/cable,
/obj/machinery/atmospherics/pipe/smart/manifold4w/supply/hidden/layer4,
/obj/machinery/atmospherics/pipe/smart/manifold4w/scrubbers/hidden/layer2,
/obj/machinery/space_heater/wall_mounted/directional/east,
/turf/open/floor/plating,
/area/ruin/icemoon_comms_station)
"J" = (
/turf/closed/wall/r_wall/rust,
/area/ruin/icemoon_comms_station)
"K" = (
/obj/effect/turf_decal/stripes/corner{
	dir = 1
	},
/obj/machinery/atmospherics/components/tank/air,
/obj/machinery/light/small/directional/north,
/turf/open/floor/plating,
/area/ruin/icemoon_comms_station)
"L" = (
/obj/effect/turf_decal/stripes/line{
	dir = 1
	},
/obj/structure/cable,
/obj/machinery/atmospherics/pipe/smart/manifold4w/supply/hidden/layer4,
/obj/machinery/airalarm/directional/east,
/obj/effect/mapping_helpers/airalarm/unlocked,
/turf/open/floor/plating,
/area/ruin/icemoon_comms_station)
"N" = (
/turf/closed/wall,
/area/ruin/icemoon_comms_station)
"O" = (
/obj/structure/cable,
/obj/machinery/atmospherics/pipe/layer_manifold/supply/hidden{
	dir = 4
	},
/turf/open/floor/plating,
/area/ruin/icemoon_comms_station)
"P" = (
/obj/structure/filingcabinet,
/turf/open/floor/carpet/grimey,
/area/ruin/icemoon_comms_station)
"Q" = (
/obj/structure/cable,
/obj/machinery/atmospherics/pipe/smart/manifold4w/scrubbers/hidden/layer2,
/obj/machinery/atmospherics/pipe/smart/manifold4w/supply/hidden/layer4,
/turf/open/floor/carpet/grimey,
/area/ruin/icemoon_comms_station)
"T" = (
/turf/closed/wall/r_wall,
/area/ruin/icemoon_comms_station)
"U" = (
/obj/machinery/atmospherics/components/unary/vent_pump/on/layer4{
	dir = 8
	},
/obj/structure/closet/secure_closet/freezer/fridge/all_access,
/obj/effect/spawner/random/food_or_drink/donkpockets,
/turf/open/floor/iron/dark,
/area/ruin/icemoon_comms_station)
"V" = (
/obj/structure/cable,
/obj/machinery/power/colony_wind_turbine,
/turf/open/floor/plating/snowed/smoothed/icemoon,
/area/icemoon/surface/outdoors/nospawn)
"W" = (
/obj/structure/window/reinforced/fulltile/ice,
/obj/structure/grille,
/obj/structure/cable,
/turf/open/floor/plating,
/area/ruin/icemoon_comms_station)
"X" = (
/obj/machinery/atmospherics/pipe/smart/manifold4w/scrubbers/hidden/layer2,
/obj/machinery/portable_atmospherics/canister/oxygen,
/obj/effect/turf_decal/delivery,
/obj/machinery/light/small/directional/south,
/turf/open/floor/plating,
/area/ruin/icemoon_comms_station)
"Y" = (
/obj/effect/turf_decal/stripes/corner,
/obj/structure/rack,
/obj/machinery/atmospherics/components/unary/vent_scrubber/on/layer2{
	dir = 4
	},
/obj/item/clothing/mask/gas/explorer{
	pixel_x = -4;
	pixel_y = 5
	},
/obj/item/tank/internals/emergency_oxygen/double{
	pixel_x = 6;
	pixel_y = -1
	},
/turf/open/floor/plating,
/area/ruin/icemoon_comms_station)
"Z" = (
/obj/machinery/atmospherics/pipe/smart/manifold4w/scrubbers/hidden/layer2,
/turf/open/floor/plating,
/area/ruin/icemoon_comms_station)

(1,1,1) = {"
j
j
j
j
j
a
a
a
j
j
j
a
a
a
j
"}
(2,1,1) = {"
j
j
j
a
a
a
a
a
a
a
a
a
a
a
a
"}
(3,1,1) = {"
j
j
j
a
a
a
a
a
a
a
a
a
a
a
a
"}
(4,1,1) = {"
j
j
a
a
B
N
N
T
T
J
J
T
T
a
a
"}
(5,1,1) = {"
j
a
a
a
B
A
Y
T
g
D
C
X
T
a
a
"}
(6,1,1) = {"
a
a
d
d
E
L
I
x
m
e
G
b
T
a
a
"}
(7,1,1) = {"
a
a
d
y
N
N
B
H
K
c
O
Z
T
a
a
"}
(8,1,1) = {"
a
a
r
a
V
d
V
H
H
H
l
F
T
a
a
"}
(9,1,1) = {"
a
a
d
a
a
d
a
W
v
w
Q
q
T
a
a
"}
(10,1,1) = {"
a
a
d
d
d
d
V
T
i
k
Q
s
W
a
a
"}
(11,1,1) = {"
a
a
a
a
a
d
a
W
p
U
u
P
J
a
a
"}
(12,1,1) = {"
j
a
a
a
V
d
V
T
T
T
J
J
J
a
a
"}
(13,1,1) = {"
j
j
a
a
a
a
a
a
a
a
a
a
a
a
j
"}
(14,1,1) = {"
j
j
a
a
a
a
a
a
a
a
a
a
a
a
j
"}
(15,1,1) = {"
j
j
j
j
a
a
j
j
a
a
a
j
j
j
j
"}
