//MAP CONVERTED BY dmm2tgm.py THIS HEADER COMMENT PREVENTS RECONVERSION, DO NOT REMOVE
"a" = (
/turf/template_noop,
/area/template_noop)
"d" = (
/obj/machinery/button/door/directional/east{
	id = "crater_emergency_cargo_right";
	name = "Cargo Door"
	},
/turf/open/floor/iron,
/area/shuttle/escape)
"f" = (
/obj/effect/turf_decal/stripes/line{
	dir = 8
	},
/obj/effect/turf_decal/stripes/line{
	dir = 4
	},
/obj/structure/fans/tiny/forcefield{
	dir = 4
	},
/obj/machinery/door/poddoor{
	id = "crater_emergency_cargo_right"
	},
/turf/open/floor/plating,
/area/shuttle/escape)
"h" = (
/obj/effect/turf_decal/box/corners{
	dir = 4
	},
/obj/structure/closet/crate/large/import,
/obj/effect/spawner/random/engineering/material,
/obj/effect/spawner/random/engineering/material,
/obj/effect/spawner/random/engineering/material_cheap,
/turf/open/floor/iron/large,
/area/shuttle/escape)
"j" = (
/turf/closed/wall/mineral/titanium,
/area/shuttle/escape)
"k" = (
/obj/effect/turf_decal/box/corners{
	dir = 8
	},
/obj/structure/closet/crate/large/import,
/obj/item/storage/toolbox/electrical,
/obj/item/storage/toolbox/electrical,
/obj/item/storage/toolbox/mechanical,
/obj/item/storage/toolbox/mechanical,
/turf/open/floor/iron/large,
/area/shuttle/escape)
"l" = (
/obj/machinery/door/airlock/shuttle{
	name = "Emergency Shuttle Airlock"
	},
/obj/effect/turf_decal/stripes/line{
	dir = 8
	},
/obj/effect/turf_decal/stripes/line{
	dir = 4
	},
/obj/docking_port/mobile/emergency{
	name = "Crater Emergency Shuttle"
	},
/turf/open/floor/plating,
/area/shuttle/escape)
"m" = (
/obj/machinery/power/shuttle_engine/propulsion,
/obj/effect/turf_decal/stripes/line,
/turf/open/floor/plating/airless,
/area/shuttle/escape)
"n" = (
/obj/machinery/door/airlock/engineering/glass{
	name = "Engine Room"
	},
/obj/effect/mapping_helpers/airlock/access/any/engineering/atmos,
/obj/effect/mapping_helpers/airlock/access/any/engineering/general,
/turf/open/floor/iron,
/area/shuttle/escape)
"o" = (
/obj/effect/turf_decal/stripes/line{
	dir = 8
	},
/obj/effect/turf_decal/stripes/line{
	dir = 4
	},
/obj/structure/fans/tiny/forcefield{
	dir = 4
	},
/obj/machinery/door/poddoor{
	id = "crater_emergency_cargo_left"
	},
/turf/open/floor/plating,
/area/shuttle/escape)
"p" = (
/obj/effect/turf_decal/box/corners,
/turf/open/floor/iron/large,
/area/shuttle/escape)
"q" = (
/obj/machinery/porta_turret/aux_base,
/obj/effect/turf_decal/stripes/line{
	dir = 5
	},
/turf/open/floor/plating/airless,
/area/shuttle/escape)
"r" = (
/obj/effect/turf_decal/box/corners{
	dir = 1
	},
/turf/open/floor/iron/large,
/area/shuttle/escape)
"t" = (
/turf/closed/wall/mineral/titanium/nodiagonal,
/area/shuttle/escape)
"u" = (
/obj/machinery/button/door/directional/west{
	id = "crater_emergency_cargo_left";
	name = "Cargo Door"
	},
/turf/open/floor/iron,
/area/shuttle/escape)
"x" = (
/obj/machinery/porta_turret/aux_base,
/obj/effect/turf_decal/stripes/line{
	dir = 9
	},
/turf/open/floor/plating/airless,
/area/shuttle/escape)
"y" = (
/obj/effect/turf_decal/stripes/line{
	dir = 4
	},
/turf/open/floor/iron,
/area/shuttle/escape)
"A" = (
/obj/machinery/door/airlock/mining{
	name = "Cargo Bay"
	},
/turf/open/floor/iron,
/area/shuttle/escape)
"B" = (
/turf/open/floor/iron/large,
/area/shuttle/escape)
"C" = (
/obj/machinery/porta_turret/aux_base,
/obj/effect/turf_decal/stripes/line{
	dir = 6
	},
/turf/open/floor/plating/airless,
/area/shuttle/escape)
"E" = (
/obj/effect/turf_decal/stripes/line{
	dir = 8
	},
/turf/open/floor/iron,
/area/shuttle/escape)
"G" = (
/obj/structure/window/reinforced/spawner/directional/north,
/obj/machinery/power/shuttle_engine/heater,
/turf/open/floor/plating/airless,
/area/shuttle/escape)
"H" = (
/obj/effect/decal/cleanable/dirt,
/obj/structure/sign/warning/radiation/directional/south,
/turf/open/floor/iron,
/area/shuttle/escape)
"I" = (
/obj/effect/turf_decal/box/corners,
/obj/structure/closet/crate/internals,
/obj/item/storage/toolbox/emergency,
/obj/item/tank/internals/emergency_oxygen/double,
/obj/item/tank/internals/emergency_oxygen/double,
/obj/item/tank/internals/emergency_oxygen/double,
/obj/item/tank/internals/emergency_oxygen/double,
/obj/item/tank/internals/oxygen/yellow,
/obj/item/tank/internals/oxygen/yellow,
/obj/item/tank/internals/oxygen/yellow,
/obj/item/tank/internals/oxygen/yellow,
/turf/open/floor/iron/large,
/area/shuttle/escape)
"L" = (
/obj/effect/turf_decal/box/corners{
	dir = 4
	},
/turf/open/floor/iron/large,
/area/shuttle/escape)
"M" = (
/obj/machinery/door/airlock/shuttle{
	name = "Emergency Shuttle Airlock"
	},
/obj/effect/turf_decal/stripes/line{
	dir = 8
	},
/obj/effect/turf_decal/stripes/line{
	dir = 4
	},
/turf/open/floor/plating,
/area/shuttle/escape)
"N" = (
/obj/machinery/porta_turret/aux_base,
/obj/effect/turf_decal/stripes/line{
	dir = 10
	},
/turf/open/floor/plating/airless,
/area/shuttle/escape)
"O" = (
/obj/effect/decal/cleanable/dirt,
/turf/open/floor/iron,
/area/shuttle/escape)
"P" = (
/obj/effect/decal/cleanable/dirt,
/obj/machinery/power/smes/super/full,
/turf/open/floor/iron,
/area/shuttle/escape)
"Q" = (
/turf/open/floor/iron,
/area/shuttle/escape)
"R" = (
/obj/effect/turf_decal/box/corners{
	dir = 8
	},
/turf/open/floor/iron/large,
/area/shuttle/escape)
"S" = (
/obj/effect/spawner/structure/window/reinforced/shuttle,
/turf/open/floor/plating,
/area/shuttle/escape)
"T" = (
/obj/effect/decal/cleanable/dirt,
/obj/machinery/power/terminal{
	dir = 1
	},
/obj/structure/cable,
/turf/open/floor/iron,
/area/shuttle/escape)
"V" = (
/obj/effect/turf_decal/box/corners{
	dir = 8
	},
/obj/structure/closet/crate/large/import,
/obj/item/clothing/mask/gas/explorer,
/obj/item/clothing/mask/gas/explorer,
/obj/item/clothing/mask/gas/explorer,
/obj/item/clothing/mask/gas/explorer,
/obj/item/clothing/suit/hooded/wintercoat,
/obj/item/clothing/suit/hooded/wintercoat,
/obj/item/clothing/suit/hooded/wintercoat,
/obj/item/clothing/suit/hooded/wintercoat,
/obj/item/flashlight/lantern/rayne,
/obj/item/flashlight/lantern/rayne,
/obj/item/flashlight/lantern/rayne,
/obj/item/flashlight/lantern/rayne,
/turf/open/floor/iron/large,
/area/shuttle/escape)
"X" = (
/turf/template_noop,
/area/shuttle/escape)
"Z" = (
/obj/machinery/power/rtg/advanced,
/obj/effect/turf_decal/stripes/line{
	dir = 1
	},
/obj/effect/decal/cleanable/dirt,
/obj/structure/cable,
/turf/open/floor/plating,
/area/shuttle/escape)

(1,1,1) = {"
a
a
a
a
a
a
a
a
j
M
t
l
j
N
a
x
j
M
t
M
j
a
a
a
t
t
t
N
a
a
"}
(2,1,1) = {"
a
a
a
a
a
a
a
j
j
Q
Q
Q
t
S
S
S
t
Q
Q
Q
t
o
o
o
t
O
G
m
a
a
"}
(3,1,1) = {"
a
a
a
a
x
j
t
t
t
Q
Q
Q
t
X
X
X
t
Q
Q
Q
t
E
E
E
t
O
t
t
N
a
"}
(4,1,1) = {"
a
a
a
j
t
t
X
X
t
M
t
M
t
X
X
X
t
M
t
M
t
Q
Q
Q
t
O
O
G
m
a
"}
(5,1,1) = {"
a
S
t
t
X
t
X
X
t
X
X
X
X
X
X
X
t
Q
Q
Q
u
Q
Q
Q
t
O
O
G
m
a
"}
(6,1,1) = {"
S
S
X
X
X
t
X
X
t
X
X
X
X
X
X
X
A
Q
r
V
Q
r
R
Q
t
O
H
t
t
N
"}
(7,1,1) = {"
S
X
X
X
X
t
X
X
X
X
X
X
X
X
X
X
S
Q
h
p
Q
L
p
Q
t
O
O
Z
G
m
"}
(8,1,1) = {"
S
X
X
X
X
t
X
X
X
X
X
X
X
X
X
X
S
Q
r
R
Q
r
R
Q
t
P
T
Z
G
m
"}
(9,1,1) = {"
S
X
X
X
X
X
X
X
X
X
X
X
X
X
X
X
S
Q
B
B
Q
B
B
Q
n
O
O
Z
G
m
"}
(10,1,1) = {"
S
X
X
X
X
t
X
X
X
X
X
X
X
X
X
X
S
Q
L
p
Q
L
p
Q
t
O
O
Z
G
m
"}
(11,1,1) = {"
S
X
X
X
X
t
X
X
X
X
X
X
X
X
X
X
S
Q
r
k
Q
r
R
Q
t
O
O
Z
G
m
"}
(12,1,1) = {"
S
S
X
X
X
t
X
X
t
X
X
X
X
X
X
X
A
Q
L
p
Q
L
I
Q
t
O
H
t
t
C
"}
(13,1,1) = {"
a
S
t
t
X
t
X
X
t
X
X
X
X
X
X
X
t
Q
Q
Q
d
Q
Q
Q
t
O
O
G
m
a
"}
(14,1,1) = {"
a
a
a
j
t
t
X
X
t
M
t
M
t
X
X
X
t
M
t
M
t
Q
Q
Q
t
O
O
G
m
a
"}
(15,1,1) = {"
a
a
a
a
q
j
t
t
t
Q
Q
Q
t
X
X
X
t
Q
Q
Q
t
y
y
y
t
O
t
t
C
a
"}
(16,1,1) = {"
a
a
a
a
a
a
a
j
t
Q
Q
Q
t
S
S
S
t
Q
Q
Q
t
f
f
f
t
O
G
m
a
a
"}
(17,1,1) = {"
a
a
a
a
a
a
a
a
j
M
t
M
j
C
a
q
t
M
t
M
t
a
a
a
t
t
t
C
a
a
"}
