//MAP CONVERTED BY dmm2tgm.py THIS HEADER COMMENT PREVENTS RECONVERSION, DO NOT REMOVE
"a" = (
/turf/template_noop,
/area/template_noop)
"b" = (
/obj/machinery/power/shuttle_engine/heater{
	dir = 8
	},
/obj/structure/window/reinforced/spawner/directional/east,
/obj/effect/turf_decal/stripes/line{
	dir = 1
	},
/turf/open/floor/plating,
/area/shuttle/transport)
"c" = (
/turf/closed/wall/mineral/titanium/nodiagonal,
/area/shuttle/transport)
"d" = (
/turf/closed/wall/mineral/titanium,
/area/shuttle/transport)
"e" = (
/obj/effect/spawner/structure/window/reinforced/shuttle,
/turf/open/floor/plating,
/area/shuttle/transport)
"f" = (
/obj/machinery/power/shuttle_engine/heater{
	dir = 8
	},
/obj/structure/window/reinforced/spawner/directional/east,
/obj/effect/turf_decal/stripes/line,
/turf/open/floor/plating,
/area/shuttle/transport)
"g" = (
/obj/effect/turf_decal/stripes/line{
	dir = 8
	},
/obj/effect/turf_decal/stripes/line{
	dir = 4
	},
/obj/machinery/light/floor/has_bulb,
/turf/open/floor/mineral/plastitanium,
/area/shuttle/transport)
"h" = (
/turf/open/floor/engine/hull,
/area/shuttle/transport)
"i" = (
/obj/machinery/power/shuttle_engine/heater{
	dir = 8
	},
/obj/structure/window/reinforced/spawner/directional/east,
/turf/open/floor/plating,
/area/shuttle/transport)
"j" = (
/obj/machinery/light/directional/west,
/obj/structure/chair/comfy/shuttle{
	dir = 1
	},
/obj/effect/turf_decal/bot,
/turf/open/floor/iron/dark/textured_large,
/area/shuttle/transport)
"k" = (
/obj/effect/turf_decal/stripes/line{
	dir = 4
	},
/obj/effect/turf_decal/stripes/line{
	dir = 8
	},
/obj/machinery/door/airlock/external/glass{
	name = "Ferry Shuttle"
	},
/obj/effect/mapping_helpers/airlock/cyclelink_helper{
	dir = 4
	},
/turf/open/floor/plating,
/area/shuttle/transport)
"l" = (
/obj/effect/turf_decal/delivery,
/turf/open/floor/iron/dark/textured_large,
/area/shuttle/transport)
"m" = (
/obj/machinery/light/directional/east,
/obj/structure/chair/comfy/shuttle{
	dir = 1
	},
/obj/effect/turf_decal/bot,
/turf/open/floor/iron/dark/textured_large,
/area/shuttle/transport)
"n" = (
/obj/machinery/power/shuttle_engine/propulsion/left{
	dir = 8
	},
/obj/effect/turf_decal/stripes/line{
	dir = 9
	},
/turf/open/floor/plating/airless,
/area/shuttle/transport)
"o" = (
/obj/machinery/light/directional/west,
/obj/effect/turf_decal/delivery,
/obj/structure/closet/crate/internals,
/obj/item/clothing/mask/gas/atmos/centcom,
/obj/item/clothing/mask/gas/atmos/centcom,
/obj/item/clothing/suit/hooded/wintercoat/centcom,
/obj/item/tank/internals/emergency_oxygen/double,
/obj/item/tank/internals/emergency_oxygen/double,
/obj/item/flashlight/lantern/rayne,
/obj/item/flashlight/lantern/rayne,
/obj/item/storage/toolbox/emergency,
/obj/item/storage/toolbox/emergency,
/turf/open/floor/iron/dark/textured_large,
/area/shuttle/transport)
"q" = (
/obj/structure/chair/comfy/shuttle{
	dir = 4
	},
/obj/effect/turf_decal/bot,
/turf/open/floor/iron/dark/textured_large,
/area/shuttle/transport)
"r" = (
/turf/open/floor/iron/dark/textured_large,
/area/shuttle/transport)
"s" = (
/obj/structure/marker_beacon/cerulean,
/turf/open/floor/engine/hull,
/area/shuttle/transport)
"t" = (
/obj/effect/turf_decal/stripes/line{
	dir = 4
	},
/obj/effect/turf_decal/stripes/line{
	dir = 8
	},
/obj/docking_port/mobile{
	dir = 8;
	shuttle_id = "ferry";
	name = "ferry shuttle";
	preferred_direction = 4
	},
/obj/machinery/door/airlock/external/glass{
	name = "Ferry Shuttle"
	},
/obj/effect/mapping_helpers/airlock/cyclelink_helper{
	dir = 8
	},
/turf/open/floor/plating,
/area/shuttle/transport)
"u" = (
/obj/machinery/power/shuttle_engine/propulsion/burst{
	dir = 8
	},
/obj/effect/turf_decal/stripes/line{
	dir = 8
	},
/turf/open/floor/plating/airless,
/area/shuttle/transport)
"v" = (
/obj/machinery/power/shuttle_engine/propulsion/right{
	dir = 8
	},
/obj/effect/turf_decal/stripes/line{
	dir = 10
	},
/turf/open/floor/plating/airless,
/area/shuttle/transport)
"w" = (
/obj/structure/chair/comfy/shuttle{
	dir = 1
	},
/obj/effect/turf_decal/bot,
/turf/open/floor/iron/dark/textured_large,
/area/shuttle/transport)
"x" = (
/obj/structure/window/reinforced/spawner/directional/south,
/obj/machinery/light/directional/east,
/obj/machinery/computer/shuttle/ferry{
	dir = 8
	},
/turf/open/floor/iron/dark/textured_large,
/area/shuttle/transport)

(1,1,1) = {"
n
u
u
u
v
"}
(2,1,1) = {"
b
i
i
i
f
"}
(3,1,1) = {"
c
o
r
j
c
"}
(4,1,1) = {"
c
l
r
w
c
"}
(5,1,1) = {"
e
l
r
w
e
"}
(6,1,1) = {"
e
q
r
w
e
"}
(7,1,1) = {"
c
x
r
m
c
"}
(8,1,1) = {"
d
c
r
c
d
"}
(9,1,1) = {"
s
c
k
c
s
"}
(10,1,1) = {"
h
e
g
e
h
"}
(11,1,1) = {"
a
c
t
c
a
"}
